0000000000000000000000000000000000000000000000000000000000000000000000000000000000000000000000000000
0000000000000000000000000000000000000000000000000000000000000000000000000000000000000000000000000000
0000000000000000000000000000000000000000000000000000000000000000000000000000000000000000000000000000
0000000000000000000000000000000000000000000000000000000000000000000000000000000000000000000000000000
0000000000000000000000000000000000000000000000000000000000000000000000000000000000000000000000000000
0000000000000000000000000000000000000000000000000000000000000000000000000000000000000000000000000000
0000000000000000000000000000000000000000000000000000000000000000000000000000000000000000000000000000
0000000011111111111111111111111111111111111111111111111111111111111111111111111111111111100000000000
0000000000000000000000000000000000000000000000000000000000000000000000000000000000000000100000000000
0000000010000000000000000000000000000000000000000000000000000000000000000000000000000000100000000000
0000000010011111111111111111111111111111111111111111111111111111111111111111111111111100100000000000
0000000010010000000000000000000000000000000000000000000000000000000000000000000000000100100000000000
0000000010010000000000000000000000000000000000000000000000000000000000000000000000000100100000000000
0000000010010011111111111111111111111111111111111111111111111111111111111111111111100100100000000000
0000000010010010000000000000000000000000000000000000000000000000000000000000000000100100100000000000
0000000010010000000000000000000000000000000000000000000000000000000000000000000000100100100000000000
0000000010010010011111111111111111111111111111111111111111111111111111111111111100100100100000000000
0000000010010010010000000000000000000000000000000000000000000000000000000000000100100100100000000000
0000000010010010010000000000000000000000000000000000000000000000000000000000000100100100100000000000
0000000010010010010011111111111111111111111111111111111111111111111111111111100100100100100000000000
0000000010010010010000000000000000000000000000000000000000000000000000000000100100100100100000000000
0000000010010010010010000000000000000000000000000000000000000000000000000000100100100100100000000000
0000000010010010010010000000000000000000000000000000000000000000000000000000100100100100100000000000
0000000010010010010010001111111111111111111111111111111111111111111111111000100100100100100000000000
0000000010010010010010001000000000000000000000000000000000000000000000001000100100100100100000000000
0000000010010010010010001000000000000000000000000000000000000000000000001000100100100100100000000000
0000000010010010010010001000000000000000000000000000000000000000000000001000100100100100100000000000
0000000010010010010010001000000000000000000000000000000000000000000000001000100100100100100000000000
0000000010010010010010001000000000000000000000000000000000000000000000001000100100100100100000000000
0000000010010010010010001000000000000000000000000000000000000000000000001000100100100100100000000000
0000000010010010010010001000000000000000000000000000000000000000000000001000100100100100100000000000
0000000010010010010010001000000000000000000000000000000000000000000000001000100100100100100000000000
0000000010010010010010001000000000000000000000000000000000000000000000001000100100100100100000000000
0000000010010010010010001000000000000000000000000000000000000000000000001000100100100100100000000000
0000000010010010010010001000000000000000000000000000000000000000000000001000100100100100100000000000
0000000010010010010010001000000000000000000000000000000000000000000000001000100100100100100000000000
0000000010010010010010001000000000000000000000000000000000000000000000001000100100100100100000000000
0000000010010010010010001000000000000000000000000000000000000000000000001000100100100100100000000000
0000000010010010010010001000000000000000000000000000000000000000000000001000100100100100100000000000
0000000010010010010010001000000000000000000000000000000000000000000000001000100100100100100000000000
0000000010010010010010001000000000000000000000000000000000000000000000001000100100100100100000000000
0000000010010010010010001000000000000000000000000000000000000000000000001000100100100100100000000000
0000000010010010010010001000000000000000000000000000000000000000000000001000100100100100100000000000
0000000010010010010010001000000000000000000000000000000000000000000000001000100100100100100000000000
0000000010010010010010001000000000000000000000000000000000000000000000001000100100100100100000000000
0000000010010010010010001000000000000000000000000000000000000000000000001000100100100100100000000000
0000000010010010010010001000000000000000000000000000000000000000000000001000100100100100100000000000
0000000010010010010010001000000000000000000000000000000000000000000000001000100100100100100000000000
0000000010010010010010001000000000000000000000000000000000000000000000001000100100100100100000000000
0000000010010010010010001000000000000000000000000000000000000000000000001000100100100100100000000000
0000000010010010010010001000000000000000000000000000000000000000000000001000100100100100100000000000
0000000010010010010010001000000000000000000000000000000000000000000000001000100100100100100000000000
0000000010010010010010001000000000000000000000000000000000000000000000001000100100100100100000000000
0000000010010010010010001000000000000000000000000000000000000000000000001000100100100100100000000000
0000000010010010010010001000000000000000000000000000000000000000000000001000100100100100100000000000
0000000010010010010010001000000000000000000000000000000000000000000000001000100100100100100000000000
0000000010010010010010001000000000000000000000000000000000000000000000001000100100100100100000000000
0000000010010010010010001000000000000000000000000000000000000000000000001000100100100100100000000000
0000000010010010010010001000000000000000000000000000000000000000000000001000100100100100100000000000
0000000010010010010010001000000000000000000000000000000000000000000000001000100100100100100000000000
0000000010010010010010001000000000000000000000000000000000000000000000001000100100100100100000000000
0000000010010010010010001000000000000000000000000000000000000000000000001000100100100100100000000000
0000000010010010010010001000000000000000000000000000000000000000000000001000100100100100100000000000
0000000010010010010010001000000000000000000000000000000000000000000000001000100100100100100000000000
0000000010010010010010001000000000000000000000000000000000000000000000001000100100100100100000000000
0000000010010010010010001000000000000000000000000000000000000000000000001000100100100100100000000000
0000000010010010010010001000000000000000000000000000000000000000000000001000100100100100100000000000
0000000010010010010010001000000000000000000000000000000000000000000000001000100100100100100000000000
0000000010010010010010001000000000000000000000000000000000000000000000001000100100100100100000000000
0000000010010010010010001000000000000000000000000000000000000000000000001000100100100100100000000000
0000000010010010010010001000000000000000000000000000000000000000000000001000100100100100100000000000
0000000010010010010010001000000000000000000000000000000000000000000000001000100100100100100000000000
0000000010010010010010001000000000000000000000000000000000000000000000001000100100100100100000000000
0000000010010010010010001000000000000000000000000000000000000000000000001000100100100100100000000000
0000000010010010010010001000000000000000000000000000000000000000000000001000100100100100100000000000
0000000010010010010010001111111111111111111111111111111111111111111111101000100100100100100000000000
0000000010010010010010000000000000000000000000000000000000000000000000000000100100100100100000000000
0000000010010010010010000000000000000000000000000000000000000000000000000000100100100100100000000000
0000000010010010010010000000000000000000000000000000000000000000000000000000100100100100100000000000
0000000010010010010011111111111111111111111111111111111111111111111111111111100100100100100000000000
0000000010010010010000000000000000000000000000000000000000000000000000000000000100100100100000000000
0000000010010010010000000000000000000000000000000000000000000000000000000000000100100100100000000000
0000000010010010011111111111111111111111111111111111111111111111111111111111101100100100100000000000
0000000010010010000000000000000000000000000000000000000000000000000000000000000000100100100000000000
0000000010010010000000000000000000000000000000000000000000000000000000000000000000100100100000000000
0000000010010011111111111111111111111111111111111111111111111111111111111111111111100100100000000000
0000000010010000000000000000000000000000000000000000000000000000000000000000000000000100100000000000
0000000010010000000000000000000000000000000000000000000000000000000000000000000000000100100000000000
0000000010011111111111111111111111111111111111111111111111111111111111111111111111101100100000000000
0000000010000000000000000000000000000000000000000000000000000000000000000000000000000000100000000000
0000000010000000000000000000000000000000000000000000000000000000000000000000000000000000100000000000
0000000011111111111111111111111111111111111111111111111111111111111111111111111111111111100000000000
0000000000000000000000000000000000000000000000000000000000000000000000000000000000000000000000000000
0000000000000000000000000000000000000000000000000000000000000000000000000000000000000000000000000000
0000000000000000000000000000000000000000000000000000000000000000000000000000000000000000000000000000
0000000000000000000000000000000000000000000000000000000000000000000000000000000000000000000000000000
0000000000000000000000000000000000000000000000000000000000000000000000000000000000000000000000000000
0000000000000000000000000000000000000000000000000000000000000000000000000000000000000000000000000000
0000000000000000000000000000000000000000000000000000000000000000000000000000000000000000000000000000
0000000000000000000000000000000000000000000000000000000000000000000000000000000000000000000000000000
