0100000000000000001000000000000000000000000000000000000100000000000000000000000000101000000001000000
0010000000000000100000100000000000000010000000000000000010000000000000000000000100000000000000000000
0010000000000000000000000000000000010100000000000100000000000000000000000000000000000000000000000000
0000000000000000000000000000000000000000000000000000000000000000100000000000000001000000000000000000
0010000001000000000000000000001000000010000101001000010000001000000000000000000001000100000000000000
0000001000000000000000000000000000000000000000100000000000000000000000000000101001000000000000000000
0000001000000000000001000000110001000000000000000000000000000000000000000010000000000010000000000000
0000100100000000000000000100000000001010000000010000000000000000000000000000000000001000000000000000
0000000000000110000000100000000000000000000000000000000000000000000000010000000000000000000000000000
0000000100000000000010000000000000000100000000000000001000000000000011000001000000000000000000000000
0000100000000000000000000001000001000000000000100000000000100000001000000000000000010000001000000000
0000010000000000100000000000000000000000000000000000000000000000000001000100000000000000000000010000
0000000000001000100000100000000001000000000000000000000010000000000000000000000000001010000000000000
0000000001000000001000010000000001100010000000000001000000000000000000100000000000000000001000000010
1000000000000000100010110101000000000000000000000000001000000000100001000100000000001000001000000000
0000000000000100000000001000100000000000000000000100000100000000000000000100100000100001000000000100
0000000000000010100100001000000000010000010100000000000010000000000000000000000010100000100000000000
0000000001000000000010000000000000110000000000000000010000011000000010000000010000000000000001000000
0000000000000000000000000001000000010000000000000000001010000000100000000000001000000000000000000000
0000000000000000000100001000000000000000001000000000000000000010010000000000001000000000010110000000
0000000001000000000000100000000000000000001000000000000100000010000110100000000000000000000000000000
0100000010000001000010001000000000100000000000000010000000000000000000001000000000000000000000000000
0000000000010000000000010100000000001000000000100000000000010000001010010000100100110000000000000000
0001000001000000011100000000000010000000001000000000000100000000000000000001000000000010000000000000
1000000000000000000000001000010000000000100010001000000100000000000000000100000000100100000000000000
0000000000000000000000000000000000000010000010000000000000000010000000000000000010000010000000000000
0000110000000000000000000001001000010100010001001000000010101010000000000001100000000000000100001000
0000000000000000001000101000001010000000000000000000100000100010001000000000100001000000000110000000
0000000000010010000010110000100001100000000000000000010001000000001001000001000000100100000000000000
0000000010001000000110000000000000001000000000000000000000010000000110000000000110010000000000000000
0000000000000001000000000000000001000000000000010000000010000000100000011000000000010000000000100000
0000000000000000000000010100000000000000000000000000000000000000000000000000001000101000000000000000
0000000000000000000000010000000000000000000000000110000000010000000000010000000000000000000100100000
0001000000001010000000000001100000001000001000000100000100000000000000000010000000100000000000000000
0000010010000000100000000100000010100001000000001000000000000000000000000000001100000000000000000000
0000000000000100000000100000000000000000100000010100001000000000010000100000000000000000100000000100
0000000000000000100000000000001000000000000000000001100000000000000000001000100000000000000000000000
0000000010010000000000000000000000000000000000000000000000010000001010000010000000000000000000100000
0000000000000000000001000000000000000001000000111000010010000000110000000000010100110000010000010000
0000000000000000001001000000000000000000000100000000000001000000000000000000010010000000000000000100
0000000000000000000000000110000000000100000000000000000100000001000100000000000001000000000000000000
0000000000000001000000000000000000000001000100000010001000001000000000000000000000000000001000000010
0000000000110000000000101101000001000100010000001001000000010000011000000000000000000000000000000000
0000000001000000000000000000000000000000000000000000001000000010000000000000010010000000000000000000
0000000000000100000000010010000000000000000000000010000011000000010000000000000000000010000000000010
0000000000110000001100000000101000010000000100000000000000000000000000000101000000000000100000000000
0001010000000010000000001000000000000000000000010000000100000000000001000000000100000000101000000000
0000000000100000000000100000000000001000000000010000010000000000000000010000000000010100000000000000
0000000000000010000010000000000000010010001100000000100100000000100000000000000001000100001000000100
0000000000000000000000100000001010001000100000000100000000000000110000000000000000000000000000000000
0000000000001000000000000000000000000100100000001000100010100000001000000010000000000001000000000000
0000000000000000010000000000110000000100000000000100000100000000000000000000001000000000000000000000
0000000000000000000000000100001000000000000100000000000000000000001000000000000000000000000000000110
0000000000000000001000100000000010000010000100010000000000000100000000000001000000000000000001000000
0000000000000000000000000000000000000000000000000000000000000001010000000010000000000001000000000000
0000000100000010000001000100000000000000000000001001000001000000000000000000000100000000000000000000
0000000000000000000000100000000000000000001100000000000010011000000000000000000000000000000100000000
0000000000101000000001000001000011000010000001000010000111000010000000000000000100000001000001000100
0000000000000000010000010000101001000110000000000000000010100000000001000000000000000000000000000000
0000000000000000000001000010000000000000000101000000000000000001000000001100000000000000000010000000
0000010000001000000000100000100000000000000000000000000000000000000001001000000000000000000000000000
0000000000000000000100001000000000000000000000000000101000000000000010100000010000000000000000000000
0000010000000000000000000000000000000000000000011000000000000000001000000001100000000000001000001000
0000000000000010000000000010010100000000000010010100000010000100001100000000000000100010000000000000
0000000000100000000000000010010000000000000100000000000000000110000000000000000000000000000000100000
0000000000000000000100101010100000000000000000100010010000010000000000000000000000000000000000000000
0000001000000000001001010110000100000000001100001000000000000000001000000101000000000000000001000000
0000000000000000000000000000101010000001100001000000100000000011000100000000001100000000000000000000
0000000000000000000000010000000000000000000000000000000010000010000000000100110001000000000000100000
0100000000000000000100000100000000000100000110000000000000000000000000001001000000000000000100000010
0000000000000000001000000000000000000000000010000000000000000000010000000110000000010000000000000100
0000000000000000000011000000010000000000000000000000000010000000000000110000000100000010000000000000
0000000010010000000000001000000010000000000010000000001000000110000001000000000000000100000000001000
0000000000000001000000100000010000100000001000000000000000100100000000010100000000000000000000000000
0000000000000000000000000000000000000000000000000101000000100000001000001010000010000000000000000000
0100000000000000000000000000000000100000000010000000000010000010000100000000001000000000000000000000
0000000000001000010000100000000000000000000000000000000010100000100000100100000000000100000000000000
0000000000000100000000000000000000000000000000000000000000000000000000000000010000000000000000000000
0100100000100000000000000001000001000000000000000000000000000100001000000000000000000010000100000000
0000000000000001000000001000000000000000000000000000100001000100000000000000000000000000000000000000
0000000000000000000111000000110000000010000100001000000000000000000000000010000000010000000000000010
0000000000000000000000000000000000000000000010000000000100000100000000000010000000000000110000000000
0000000000000110000000000100001000100000000000100010000000000000001001100000000000001000000000000000
0000000000000000000000000010001000100000110000000000000000000000000000000000000000100000000010000000
0000010000000000000000000000000100000000000000000000000011000000000100000000000100010100000000100000
0000000000000000000000001000000000000000000000000001000100100100000000000000000000000000000000000000
0000000000000010000000000000010000000010000000000000000000000000001000111000010000000000010000000000
0000000000000000000000000001000000011000000000000000011010000010110100001000000000000000001001000000
0000000000000100000000000000000000000000000000000000000000000000000000000001010000000000001000000000
0000000000000000001100000000010000000000001000000000000000000000000000000000000000000100001000000000
0000000000000000000000000100010000000000000000000000000000000000000000000000000000000000000000000000
0000000010000000000000000000000000000000100000000000000000000000000000000100000000000000000000100000
0000001000000000000000000000000000000000000000000001000000000100000000000000001000000000001001000000
0000000000000101000010000000000010000000000000010000100000000010000000000000010000011000000000000000
0000000000000000000000000000000000000010000000000000000000000001000000000010000000000000010000000000
0000000000000000000000000000000000000000000000000000100000000000000000001100000001000010000000000000
0000000000000000000000000000000000000000000000000000001000000000000000000000000000000000000000000001
0000000000000001000000100000000000000000000000000000000000000000000000000010100000000000000000000000
0000001000000000000000000000000011000000000000000000000000000000000000000000000000000000000000000000
0000000000010000000000000000000000000000000000000000010000000100000000000000000000001000000000000000
